**********
*   @    *
* ***** @*
*   *     
*** *    *
*   *    *
*@*     @*
**********
